7,0,2,0,0,4,0,0,6
0,3,0,9,0,8,0,0,7
0,0,4,0,0,0,9,0,1
0,0,0,0,0,0,7,0,4
0,0,6,0,0,0,3,0,0
0,0,1,0,9,2,0,0,0
0,1,0,0,0,0,0,0,2
6,2,0,1,7,9,4,0,0
0,4,0,0,8,0,0,0,0
4,0,0,0,0,0,0,1,0
0,0,0,4,0,2,3,0,0
8,3,6,0,1,0,0,0,0
2,0,0,0,6,0,0,5,7
0,9,0,5,0,0,6,0,1
0,0,7,1,0,0,0,0,0
0,0,0,0,8,6,0,0,3
7,0,0,0,0,0,0,0,0
6,4,0,0,7,0,0,0,2
0,0,0,0,0,1,4,7,0
0,0,9,0,3,2,0,8,0
6,0,0,0,0,0,0,0,0
0,0,0,3,8,0,0,0,4
0,8,0,6,0,0,0,0,2
0,0,0,2,0,5,3,0,0
0,3,7,0,4,0,6,0,9
2,0,0,0,0,0,0,0,0
0,0,0,0,0,0,0,0,1
0,5,0,0,0,4,0,0,0
0,0,0,0,0,3,0,0,8
7,0,0,0,0,0,9,0,0
0,3,0,0,9,1,0,0,0
0,0,0,7,0,0,0,3,6
0,0,2,0,0,0,8,0,0
6,0,8,0,0,0,4,0,3
0,0,0,0,2,0,0,6,0
0,0,0,0,6,7,0,0,0
2,3,5,0,0,0,0,7,0
0,0,8,0,0,0,0,0,0
0,0,0,0,2,3,0,4,0
8,6,4,0,0,0,0,0,0
0,0,7,0,0,6,0,8,5
0,0,0,0,7,2,0,0,0
0,5,0,0,6,7,0,1,8
0,0,1,0,0,0,0,0,0
9,0,0,1,0,0,0,2,3
0,0,0,4,0,3,8,0,0
5,0,0,0,9,0,0,0,0
0,8,6,0,0,0,0,0,7
0,0,5,2,0,0,0,8,4
0,2,1,0,0,0,0,5,0
0,0,0,0,0,0,7,0,9
1,5,0,7,0,0,9,0,8
4,9,0,0,1,0,2,0,0
0,0,0,0,0,0,0,7,1
