3,5,0,0,0,0,0,8,0
0,0,0,0,5,8,9,0,2
0,0,0,0,0,7,0,0,0
0,1,0,0,0,5,0,4,0
0,0,0,7,0,0,0,9,0
0,0,9,0,1,2,0,0,7
0,0,0,0,0,0,0,0,3
6,0,0,2,0,0,0,0,0
0,0,2,3,0,0,1,0,8
0,6,5,0,0,4,0,9,0
1,0,0,0,0,0,0,0,4
8,0,0,0,0,1,0,0,0
0,0,0,2,0,3,0,0,9
0,0,0,1,0,6,3,0,7
0,5,3,4,0,9,0,0,0
0,9,7,6,0,0,0,0,0
0,0,6,5,0,0,0,7,8
3,0,8,9,0,0,4,0,5
0,0,2,0,0,5,0,0,0
7,0,3,0,0,0,9,8,5
8,0,0,0,0,0,1,0,6
0,0,7,0,0,0,0,0,0
0,0,0,3,0,8,0,0,0
3,1,6,0,4,0,0,0,0
0,3,0,8,1,0,7,9,2
0,7,8,0,0,2,6,0,0
2,0,0,0,0,0,0,0,3
0,1,2,4,0,0,9,0,7
0,0,0,6,0,0,0,0,2
5,0,0,0,9,2,0,0,4
0,0,8,0,0,0,0,1,9
4,0,5,8,0,0,0,0,0
7,0,0,0,0,0,0,0,0
0,0,3,1,0,0,8,0,0
0,0,0,5,0,4,0,2,0
0,0,0,7,0,0,3,0,0
0,0,0,0,0,0,5,0,0
3,0,8,0,0,0,1,0,7
5,9,0,0,0,0,6,8,4
0,0,1,8,4,0,0,0,3
6,0,0,0,0,5,0,0,8
4,0,0,0,3,0,0,1,0
0,4,0,0,0,0,7,0,1
0,0,0,0,0,0,0,6,9
0,0,0,7,2,9,0,4,0
0,0,4,0,0,0,5,0,0
5,9,0,0,0,0,4,7,0
2,0,7,0,1,0,0,0,9
0,0,0,0,8,0,7,5,0
0,0,8,1,0,0,0,0,0
6,0,0,0,4,0,0,8,0
0,1,0,0,0,6,0,0,0
9,0,0,7,3,0,8,0,0
7,0,0,9,0,0,0,0,2
